     ###
#####   ####
#       @   #
 # $ *    .  ################
  #####   ###
       ###
#  ##          #
# #            ##
#  #     #########
#   #    #     ##
# ##     #     #
#        #
#  ##    #
# #      #
# #    #####
# #     ###
#  ##    #
#
# ##
# # #
# ##
# # #
# # #
#
#  #
# # #
# # #
# # #
#  #
#
# #
# #
# #
# #
# ###
#
# #
# #
# #
# #
# ###
#
